11111111
100P0001
100C00E1
11111111