1111111111
10P0000001
100C0000E1
1111111111