11111111
10000001
10P00111
10000C11
1E000001
11111111