1111111111111111111111
100001000111000000C011
1P0C0100E100000C000011
1000100000000C00000011
1111111111111111111111