1111111111111111111111
100001000111000000E011
1P0C01000100000C000011
1000000000000C00000011
1111111111111111111111