111111111
100001111
10P001111
100001111
10C001111
111111111