1111111111111111111111
1P00000000C0001E000001
1110000100111011100101
1C000001C00000000001C1
1111111111111111111111