1111111111111111111111
1000010C0111000001E011
1P0C01000100000C011111
1000000000000C0000C011
1111111111111111111111