11111111
10000001
1P0000C1
11100111
10000001
100E0001
10000C01
11111111