11111111
10000001
1P0000C1
11100111
10000001
10000001
1E000C01
11111111